ImageID	ClassID
apryzkbgzo	ajuntament
bherjuwtmj	ajuntament
csiorchxrt	ajuntament
cutslwrepl	ajuntament
duhybtasph	ajuntament
eetptsxwff	ajuntament
flojjqlshy	ajuntament
fpdppotyku	ajuntament
fvqluyofrv	ajuntament
ghnrzybomd	ajuntament
gojmajriny	ajuntament
igrmibolkq	ajuntament
kckrwsquuh	ajuntament
lgolatjdav	ajuntament
mlgkmoahmx	ajuntament
mzxruutdbm	ajuntament
pejiviioql	ajuntament
usupnoctwi	ajuntament
wxvnwrahex	ajuntament
ynnruqbyvs	ajuntament
ctmgdruhhr	castell_cartoixa
demxyciylg	castell_cartoixa
eicdsetliu	castell_cartoixa
espblhcxne	castell_cartoixa
felpztwjgp	castell_cartoixa
fjlzmnempz	castell_cartoixa
gypycuakxz	castell_cartoixa
hmnkhgzisr	castell_cartoixa
htqdpikfgp	castell_cartoixa
hwvashfguz	castell_cartoixa
iisqrxzniu	castell_cartoixa
ilirgacvse	castell_cartoixa
iolslstzam	castell_cartoixa
lvmbufrqix	castell_cartoixa
qhaqcagujg	castell_cartoixa
tohxaxbiwl	castell_cartoixa
xctqfgldpb	castell_cartoixa
xmatkbedel	castell_cartoixa
zjoaswwmrn	castell_cartoixa
zogfruciti	castell_cartoixa
eungueppki	catedral
fozsogzqhs	catedral
gydmrzabbf	catedral
gzzzddpdeb	catedral
hvcofmeong	catedral
ibebtxottg	catedral
jyffzxufhm	catedral
kpjgembqar	catedral
ldrhkfwshb	catedral
ldsgeqyzqz	catedral
mwgofarupu	catedral
srswvqlmgs	catedral
tlnpqbqbmr	catedral
vcukaabxfn	catedral
vfcqcjppgy	catedral
xinsodqggc	catedral
ypelncrsyz	catedral
zdwfqkunbl	catedral
zkqidyausm	catedral
zyfayciwnt	catedral
abmnqscrfp	desconegut
abvqemvcgu	desconegut
atpnzcxris	desconegut
awgseqwken	desconegut
bikxunekjf	desconegut
clyxdmavmp	desconegut
cqgphxlxoe	desconegut
dauhvzmguk	desconegut
dgniokpfwv	desconegut
dgzibuuvlb	desconegut
dgzsrdngao	desconegut
dzgvdozjlu	desconegut
edbfzpiivc	desconegut
ephwzarrjc	desconegut
ezbubwajce	desconegut
fbxhfoqflo	desconegut
fgetgrnwjo	desconegut
fkjwfjdopi	desconegut
ghqndxjiez	desconegut
gpvldqvegu	desconegut
gsmmhprjtl	desconegut
hcdxrnipse	desconegut
hfobsjfmyb	desconegut
hknabifmhb	desconegut
htbtbmarqn	desconegut
htmnhqwxhb	desconegut
iivxdqlugs	desconegut
iwtplbyjbw	desconegut
ixjscgsarr	desconegut
jfrqihledz	desconegut
jnkvismwek	desconegut
jvgnmmypye	desconegut
jwgjzfxfjk	desconegut
jyaektqgbc	desconegut
khlpcbimjs	desconegut
klwopwvkkq	desconegut
ljmmdknpcc	desconegut
ljxktgyrev	desconegut
llouurrtkv	desconegut
llvryluksb	desconegut
lnlveepako	desconegut
lwmfadglfb	desconegut
mcrknydyxm	desconegut
mgfyoybycy	desconegut
mxcpymhbdp	desconegut
mxklaasmxc	desconegut
njskmfiohk	desconegut
nmqgfekyrt	desconegut
nnistytjdz	desconegut
nyoanninyv	desconegut
obpcdjufvm	desconegut
ofcqpmxwxq	desconegut
ofonejolpo	desconegut
ooghlovdku	desconegut
osadmyljtl	desconegut
ovwelppqko	desconegut
pbhhnfjehk	desconegut
peywdnczvq	desconegut
piiiahqosw	desconegut
qnwngybnhm	desconegut
qoaflmlhdl	desconegut
qpgxoqyetj	desconegut
rbieqpikdu	desconegut
rklfezaahd	desconegut
rodxltbrmg	desconegut
rprjjykstn	desconegut
rvucexuifa	desconegut
ryidqmlayl	desconegut
sbydryfvho	desconegut
shaocdykyz	desconegut
sxirhhyhxb	desconegut
syqfcdtrpg	desconegut
tuvsmjkgxp	desconegut
ucacqwirmb	desconegut
ulawlgobgi	desconegut
uvotazsseg	desconegut
uzwtxqsxtz	desconegut
vdwpkztnex	desconegut
vejfnalemo	desconegut
vhuafosgvq	desconegut
voulsselsf	desconegut
vxrubgcaab	desconegut
wjlxvjrslx	desconegut
wonaheimbd	desconegut
wrnfchnbpx	desconegut
xehbnlalpp	desconegut
xkyonqvfzo	desconegut
xrzauydsaq	desconegut
xsgzjrscqf	desconegut
xtxqognvfq	desconegut
xweljqqhmy	desconegut
xxasbfobuu	desconegut
xyautkeqso	desconegut
ygnkhaeolo	desconegut
ypqeosmtjm	desconegut
ysbuemtuen	desconegut
ywbbzkulrs	desconegut
yyuzssifyz	desconegut
zctwhsyxkr	desconegut
zhttgbzlfl	desconegut
zuadhxjdul	desconegut
zxdunjinnj	desconegut
zxxcohxdaj	desconegut
aolvynwgpr	dona_treballadora
cjhzvearil	dona_treballadora
errnrrwwny	dona_treballadora
hrjjswnqck	dona_treballadora
hxtjqpbzsf	dona_treballadora
joyheutbsz	dona_treballadora
lrmxbghqsl	dona_treballadora
ompthzyvoj	dona_treballadora
penzqbtmmr	dona_treballadora
rljocybimy	dona_treballadora
rltcvhodfi	dona_treballadora
rqaxbdxmjd	dona_treballadora
shqmzsxmsk	dona_treballadora
smyesjtipz	dona_treballadora
sxdrgvpnvx	dona_treballadora
vbpbbbwcqx	dona_treballadora
wwovntmwjb	dona_treballadora
zdtvlxfgzm	dona_treballadora
adlnzrlzqb	escola_enginyeria
blrvaarutk	escola_enginyeria
cmkimnrmte	escola_enginyeria
ctamqiedjm	escola_enginyeria
cwqhwutehr	escola_enginyeria
eaivltcuac	escola_enginyeria
etmbvlyqnn	escola_enginyeria
fkozanlasn	escola_enginyeria
fpvawaydky	escola_enginyeria
hcvbwcvqwm	escola_enginyeria
hfzejxzhqc	escola_enginyeria
hoemxmreym	escola_enginyeria
lnokdaqszy	escola_enginyeria
ndhloipjye	escola_enginyeria
nxapgsmtju	escola_enginyeria
qgjrtlrwef	escola_enginyeria
qqxtifamyf	escola_enginyeria
rdfqyndwah	escola_enginyeria
sveyssigrp	escola_enginyeria
syaqrclfmc	escola_enginyeria
wfrnrtsdaw	escola_enginyeria
xfvdkxsutd	escola_enginyeria
zgwkdluyby	escola_enginyeria
dmkojxqhix	estacio_nord
eixltjoazs	estacio_nord
ejpivyiafb	estacio_nord
erazghmpwo	estacio_nord
etyxgicyvo	estacio_nord
fdyxkaeeua	estacio_nord
fqburvtvhe	estacio_nord
gsjsiurlje	estacio_nord
jqkiheolac	estacio_nord
krqcghdvar	estacio_nord
ktojhhhfpd	estacio_nord
lhrsdzsxzt	estacio_nord
lwysgnwqac	estacio_nord
nkhjjpuwds	estacio_nord
okxeatzpfy	estacio_nord
pfxlropate	estacio_nord
qhrvxsftvc	estacio_nord
tmleyaixti	estacio_nord
xbpylkgafa	estacio_nord
yucisgvhxz	estacio_nord
zrzjskjvmg	estacio_nord
bpbkfismtp	farmacia_albinyana
csuywiftxy	farmacia_albinyana
efjkynypfg	farmacia_albinyana
eqpvgmuagt	farmacia_albinyana
eqxyelmuqa	farmacia_albinyana
fjucalonnk	farmacia_albinyana
iaqecjnxwe	farmacia_albinyana
iorgoelytu	farmacia_albinyana
isfxlqxffv	farmacia_albinyana
jspyaoblko	farmacia_albinyana
ltpwmwgvka	farmacia_albinyana
ndzqtnrtvi	farmacia_albinyana
oxaxkotwlf	farmacia_albinyana
pmcikbmdxi	farmacia_albinyana
qaiiwmerqt	farmacia_albinyana
qfxhlbqgml	farmacia_albinyana
rfbnelyhbx	farmacia_albinyana
vheessypeu	farmacia_albinyana
xecpqgvvwk	farmacia_albinyana
zycoulfrwp	farmacia_albinyana
ainndahneu	masia_freixa
fehunmxyyb	masia_freixa
fimnnelaax	masia_freixa
fkzokztupx	masia_freixa
hjveqhfyif	masia_freixa
mazqoabdfn	masia_freixa
mqevjphuwz	masia_freixa
pdjngqozhd	masia_freixa
pwlfdozknh	masia_freixa
qoghcoikwd	masia_freixa
rcvhwtgjml	masia_freixa
rlknhlbvbf	masia_freixa
rwilgkznbh	masia_freixa
rwsorrlbvc	masia_freixa
sjhqoozptm	masia_freixa
vhtslxjumu	masia_freixa
wljclqbfrc	masia_freixa
wqjvoorhgx	masia_freixa
xtsftumjnk	masia_freixa
yuqifkymla	masia_freixa
zebkovhggx	masia_freixa
adpcqmgnet	mercat_independencia
cnptxmiuvq	mercat_independencia
enzoddpqac	mercat_independencia
euzczasuag	mercat_independencia
fmxlnwhgup	mercat_independencia
frvrpydkzc	mercat_independencia
fuqeadsgvy	mercat_independencia
hrygwofvjs	mercat_independencia
ipxgesdtes	mercat_independencia
itctmchpqz	mercat_independencia
ncoobcgrtc	mercat_independencia
pffhxyojke	mercat_independencia
sakkaazhrs	mercat_independencia
sfipeqzjfo	mercat_independencia
teorwqupmy	mercat_independencia
ufnczwwrsh	mercat_independencia
ybjpmqkmty	mercat_independencia
ygjfgegkph	mercat_independencia
ypdgxcuwww	mercat_independencia
yucvgdarsa	mercat_independencia
dnhdpmvowg	mnactec
epdcgckuba	mnactec
erioxqwuxl	mnactec
fnqzfagyhq	mnactec
gracsmtpeo	mnactec
grivvivuqg	mnactec
hvvuvacxha	mnactec
ibcmferlnm	mnactec
keapqzhuei	mnactec
kktcpeqrdl	mnactec
ogzchofire	mnactec
rwjvfspstf	mnactec
tayopuahgv	mnactec
tgvyrafubz	mnactec
ugfnvkasjo	mnactec
xyvftmuwej	mnactec
ybciuozrvd	mnactec
ymjacykrpz	mnactec
yripjijxui	mnactec
zyimsyxfbv	mnactec
bdectbzghc	societat_general
clpjpzcwjq	societat_general
enhswxaktl	societat_general
fflkqhppay	societat_general
fkgloxacrf	societat_general
gebxzcrnsa	societat_general
guktrinwwh	societat_general
gxdtadvvqu	societat_general
hlcacypqfb	societat_general
hxatwocazs	societat_general
isjsicbbja	societat_general
iufziqbbdk	societat_general
jvettlowqj	societat_general
kejiiyirun	societat_general
kxdhwaqnuo	societat_general
lzdyyznaoa	societat_general
mknmpwoxpt	societat_general
mwsxaqggkk	societat_general
ocflplwuet	societat_general
pkatgwteqm	societat_general
pponprbpyu	societat_general
pvmjkocthx	societat_general
slhaaoozgd	societat_general
sowjkrqzki	societat_general
swmfbcgusa	societat_general
tbkgdfbzea	societat_general
twrzdzrpyd	societat_general
wvojkoblhq	societat_general
xbtbfhuors	societat_general
ywgfoajydk	societat_general
zerdaexiyv	societat_general
aalfirydrf	teatre_principal
biidrmkdha	teatre_principal
bkivawfqfs	teatre_principal
coghqqdujn	teatre_principal
dnjrflfgfg	teatre_principal
fhhqgkohsg	teatre_principal
fthidrzcvc	teatre_principal
ggkrwxxaej	teatre_principal
gjbrrzcsao	teatre_principal
hbsvuzssaf	teatre_principal
jpzsupvwza	teatre_principal
khiljdphgm	teatre_principal
llzpnrdsos	teatre_principal
mxqkcybvsp	teatre_principal
oiigffkhwb	teatre_principal
quiavtzyza	teatre_principal
tvfiqhnrdt	teatre_principal
ummgqrrzbr	teatre_principal
upmtgyneyb	teatre_principal
vijboqwdzf	teatre_principal
